3 3 3 3 3 3 3 3 3 3 3 3 3 3 3 3 3 3 3 3 3 3 3 3 3 3 3 3 3 3 3 3 3 3 3 3 3 3 3 3 3 3 3 3 3 3 3 3 3 3 4 4 4 4 4 4 4 4 4 4 4 4 4 4 4 4 4 4 4 4 4 4 4 4 4 4 4 4 4 4 4 4 4 4 4
3 3 3 3 3 3 3 3 3 3 3 3 3 3 3 3 3 3 3 3 3 3 3 3 3 3 3 3 3 3 3 3 3 3 3 3 3 3 3 3 3 3 3 3 3 3 3 3 3 3 4 4 4 4 4 4 4 4 4 4 4 4 4 4 4 4 4 4 4 4 4 4 4 4 4 4 4 4 4 4 4 4 4 4 4
3 3 3 3 3 3 3 3 3 3 3 3 3 3 3 3 3 3 3 3 3 3 3 3 3 3 3 3 3 3 3 3 3 3 3 3 3 3 3 3 3 3 3 3 3 3 3 3 3 3 4 4 4 4 4 4 4 4 4 4 4 4 4 4 4 4 4 4 4 4 4 4 4 4 4 4 4 4 4 4 4 4 4 4 4
3 3 3 2 2 2 2 2 2 2 2 4 4 4 4 4 4 3 3 3 3 3 3 3 3 3 3 3 3 3 3 3 3 5 5 5 5 5 5 5 5 5 5 5 5 5 5 3 3 3 4 4 4 4 4 4 4 4 4 4 4 4 4 4 4 4 4 4 4 4 4 4 4 4 4 4 4 4 4 4 4 4 4 4 4
3 3 3 2 2 2 2 2 2 2 2 4 4 4 4 4 4 4 4 3 3 3 3 3 3 3 3 3 3 3 3 3 3 5 6 6 6 5 6 6 6 6 6 6 6 6 5 3 3 3 4 4 4 4 4 4 4 4 4 4 4 4 4 4 4 4 4 4 4 4 4 4 4 4 4 4 4 4 4 4 4 4 4 4 4
3 3 3 2 2 2 2 2 2 2 4 4 4 4 4 4 4 4 4 4 4 3 3 3 3 3 3 3 3 3 3 3 3 5 6 6 6 5 6 6 6 6 6 6 6 6 5 3 3 3 4 4 4 4 4 4 4 4 10 10 10 10 10 10 10 10 10 10 10 10 10 10 10 10 10 10 10 10 4 4 4 4 4 4 4
3 3 3 2 2 2 2 2 2 2 4 4 4 4 4 4 4 4 4 4 4 3 3 3 3 3 3 3 3 3 3 3 3 5 5 6 5 5 6 6 6 6 6 6 6 6 5 3 3 3 4 4 4 4 4 4 4 4 10 10 10 10 10 10 10 10 10 10 10 10 10 10 10 10 10 10 10 10 4 4 4 4 4 4 4
3 3 3 2 2 2 2 2 2 2 4 4 4 4 4 4 4 4 4 4 4 4 4 4 4 3 3 3 3 3 3 3 3 5 6 6 6 6 6 6 6 6 6 6 6 6 5 3 3 3 4 4 4 4 4 4 4 4 10 10 10 10 10 10 10 10 10 10 10 10 10 10 10 10 10 10 10 10 4 4 4 4 4 4 4
3 3 3 2 2 2 2 2 2 2 2 4 4 4 4 4 4 4 4 4 4 4 4 4 4 3 3 3 3 3 3 3 3 5 6 6 6 6 6 6 6 6 6 6 6 6 5 3 3 3 4 4 4 4 4 4 4 4 10 10 10 10 10 10 10 10 10 10 10 10 10 10 10 10 10 10 10 10 4 4 4 4 4 4 4
3 3 3 2 2 2 2 2 2 2 2 2 4 4 4 4 4 4 4 4 4 4 4 4 4 3 3 3 3 3 3 3 3 5 6 6 6 6 6 6 6 6 6 6 6 6 5 3 3 3 4 4 4 4 4 4 4 4 10 10 10 10 10 10 10 10 10 10 10 10 10 10 10 10 10 10 10 10 4 4 4 4 4 4 4
3 3 3 2 2 2 2 2 2 2 2 2 4 4 4 4 4 4 4 4 4 4 4 4 4 3 3 3 3 3 3 3 3 5 6 6 6 6 6 6 6 6 6 6 6 6 5 3 3 3 4 4 4 4 4 4 4 4 10 10 10 10 10 10 10 10 10 10 10 10 10 10 10 10 10 10 10 10 4 4 4 4 4 4 4
3 3 3 2 2 2 2 2 2 2 2 2 4 4 4 4 4 4 4 4 4 4 4 4 4 3 3 3 3 3 3 3 3 5 6 6 6 6 6 6 6 6 6 6 6 6 5 3 3 3 4 4 4 4 4 4 4 4 10 10 10 10 10 10 10 10 10 10 10 10 10 10 10 10 10 10 10 10 4 4 4 4 4 4 4
3 3 3 2 2 2 2 2 2 2 2 2 2 4 4 4 4 4 4 4 4 4 4 4 4 3 3 3 3 3 3 3 3 5 6 6 6 6 6 6 6 6 6 6 6 6 5 3 3 3 4 4 4 4 4 4 4 4 10 10 10 10 10 10 10 10 10 10 10 10 10 10 10 10 10 10 10 10 4 4 4 4 4 4 4
3 3 3 2 2 2 2 2 2 2 2 2 2 2 4 4 4 4 4 4 4 4 4 3 3 3 3 3 3 3 3 3 3 5 6 6 6 6 6 6 6 6 6 6 6 6 5 3 3 3 4 4 4 4 4 4 4 4 10 10 10 10 10 10 10 10 10 10 10 10 10 10 10 10 10 10 10 10 4 4 4 4 4 4 4
3 3 3 2 2 2 2 2 2 2 2 1 2 2 2 2 2 2 2 2 4 4 4 3 3 3 3 3 3 3 3 3 3 5 6 6 6 6 6 5 6 6 5 6 6 6 5 3 3 3 4 4 4 4 4 4 4 4 10 10 10 10 10 10 10 10 10 10 10 10 10 10 10 10 10 10 10 10 4 4 4 4 4 4 4
3 3 3 2 2 2 2 2 2 2 2 2 2 2 2 2 2 2 2 2 4 4 4 3 3 3 3 3 3 3 3 3 3 5 5 5 5 5 5 5 6 6 5 5 5 5 5 3 3 3 4 4 4 4 4 4 4 4 10 10 10 10 10 10 10 10 10 10 10 10 10 10 10 10 10 10 10 10 4 4 4 4 4 4 4
3 3 3 2 2 2 2 2 2 2 2 2 2 2 2 2 2 2 2 2 0 0 2 2 2 3 3 2 2 2 2 2 2 2 2 2 2 3 2 2 0 0 2 2 2 2 2 3 3 3 4 4 4 4 4 4 4 4 10 10 10 10 10 10 10 10 10 10 10 10 10 10 10 10 10 10 10 10 4 4 4 4 4 4 4
3 3 3 2 2 2 2 2 2 2 2 2 2 2 2 2 2 2 2 2 0 0 2 2 2 3 3 2 2 2 2 2 2 2 2 2 3 3 2 2 0 0 2 2 2 2 2 3 3 3 4 4 4 4 4 4 4 4 10 10 10 10 10 10 10 10 10 10 10 10 10 10 10 10 10 10 10 10 4 4 4 4 4 4 4
3 3 3 2 2 2 2 2 2 2 2 2 2 2 2 2 2 2 2 2 0 0 2 2 2 3 3 2 2 2 2 2 2 2 2 3 2 3 2 2 0 0 2 2 2 2 2 3 3 3 4 4 4 4 4 4 4 4 10 10 10 10 10 10 10 10 10 10 10 10 10 10 10 10 10 10 10 10 4 4 4 4 4 4 4
3 3 3 2 2 2 2 2 2 2 2 2 2 2 2 2 2 2 2 2 0 0 2 2 3 3 2 2 2 2 2 2 2 2 2 2 3 3 2 2 0 0 2 2 2 2 2 3 3 3 4 4 4 4 4 4 4 4 10 10 10 10 10 10 10 10 10 10 10 10 10 10 10 10 10 10 10 10 4 4 4 4 4 4 4
3 3 3 2 2 2 2 2 2 2 2 2 2 2 2 2 2 2 2 2 0 0 2 2 3 2 2 2 2 2 2 2 2 2 2 2 2 3 2 0 0 0 2 2 2 2 2 3 3 3 4 4 4 4 4 4 4 4 10 10 10 10 10 10 10 10 10 10 10 10 10 10 10 10 10 10 10 10 4 4 4 4 4 4 4
3 3 3 2 2 2 2 2 2 2 2 2 2 2 2 2 2 2 2 0 0 0 2 3 3 3 2 2 2 2 2 2 2 2 2 3 3 2 0 0 0 2 2 2 2 2 2 3 3 3 4 4 4 4 4 4 4 4 10 10 10 10 11 11 11 11 11 11 11 11 11 11 11 11 11 10 10 10 4 4 4 4 4 4 4
3 3 3 2 2 2 2 2 2 2 2 2 2 2 2 2 2 2 0 0 0 2 2 2 3 2 2 2 2 2 2 2 2 2 2 2 3 2 0 0 0 2 2 2 2 2 2 3 3 3 4 4 4 4 4 4 4 4 10 10 10 10 11 10 10 10 10 10 10 10 11 06 06 06 11 10 10 10 4 4 4 4 4 4 4
3 3 3 2 2 2 2 2 2 2 2 2 2 2 2 2 2 0 0 0 2 2 2 3 3 2 2 2 2 2 2 2 2 2 2 3 2 2 0 0 2 2 2 2 2 2 2 3 3 3 4 4 4 4 4 4 4 4 10 10 10 10 11 10 10 10 10 10 10 10 11 06 15 06 11 10 10 10 4 4 4 4 4 4 4
3 3 3 2 2 2 2 2 2 2 2 2 2 2 2 2 2 0 0 0 2 3 3 2 2 2 2 2 2 2 2 2 2 2 2 3 3 0 0 0 2 2 2 2 2 2 2 3 3 3 4 4 4 4 4 4 4 4 10 10 10 10 11 10 10 10 10 10 10 10 11 06 06 06 11 10 10 10 4 4 4 4 4 4 4
3 3 3 2 2 2 2 2 2 2 2 2 2 2 2 2 0 0 0 2 2 2 3 3 2 2 2 2 2 2 2 2 2 2 3 2 2 0 0 0 2 2 2 2 2 2 2 3 3 3 4 4 4 4 4 4 4 4 10 10 10 10 11 10 10 10 10 10 10 10 11 11 06 11 11 10 10 10 4 4 4 4 4 4 4
3 3 3 2 2 2 2 2 2 2 2 2 2 2 2 2 0 0 0 2 2 2 3 3 3 2 2 2 2 2 2 2 2 3 3 2 0 0 0 2 2 2 2 2 2 2 2 3 3 3 4 4 4 4 4 4 4 4 10 10 10 10 11 10 10 10 10 10 10 10 10 10 10 10 11 10 10 10 4 4 4 4 4 4 4
3 3 3 2 2 2 2 2 2 2 2 2 2 2 2 0 0 0 2 2 3 3 2 2 2 2 2 2 2 2 2 2 2 3 2 0 0 0 0 2 2 2 2 2 2 2 2 3 3 3 4 4 4 4 4 4 4 4 10 10 10 10 11 10 10 10 10 10 10 10 10 10 10 10 11 10 10 10 4 4 4 4 4 4 4
3 3 3 2 2 2 2 2 2 2 2 2 0 0 0 0 0 0 2 2 3 3 2 2 2 2 2 2 2 2 2 2 2 3 3 0 0 0 2 2 2 2 2 2 2 2 2 3 3 3 4 4 4 4 4 4 4 4 10 10 10 10 11 10 10 10 10 10 10 10 10 10 10 10 11 10 10 10 4 4 4 4 4 4 4
3 3 3 2 2 2 2 2 2 2 2 2 0 0 0 0 0 2 2 2 2 3 3 2 2 2 2 2 2 2 2 2 3 3 0 0 0 2 2 2 2 2 2 2 2 2 2 3 3 3 4 4 4 4 4 4 4 4 10 10 10 10 11 10 10 10 10 10 10 10 10 10 10 10 11 10 10 10 4 4 4 4 4 4 4
3 3 3 2 2 2 2 2 2 2 2 2 0 0 2 2 2 2 2 2 2 3 2 2 2 2 2 2 2 2 2 3 3 2 0 0 2 2 2 2 2 2 2 2 2 2 2 3 3 3 4 4 4 4 4 4 4 4 10 10 10 10 11 10 10 10 10 10 10 10 10 10 10 10 11 10 10 10 4 4 4 4 4 4 4
3 3 3 2 2 2 2 2 2 2 2 2 0 0 7 2 2 2 2 2 2 3 2 3 2 2 2 2 2 2 2 3 2 2 0 0 2 2 2 2 2 2 2 2 2 2 2 3 3 3 4 4 4 4 4 4 4 4 10 10 10 10 11 11 11 11 11 11 10 11 11 11 11 11 11 10 10 10 4 4 4 4 4 4 4
3 3 3 2 2 2 2 2 2 2 0 0 0 0 0 0 2 2 2 2 2 3 3 2 2 2 2 2 2 2 3 2 2 0 0 0 2 2 2 2 2 2 2 2 2 2 2 3 3 3 4 4 4 4 4 4 4 4 10 10 10 10 10 10 10 11 13 11 10 11 14 11 10 10 10 10 10 10 4 4 4 4 4 4 4
3 3 3 2 2 2 2 2 2 0 0 0 0 0 0 0 0 2 2 2 2 2 2 3 3 3 2 3 2 3 2 2 0 0 0 0 2 2 2 2 2 2 2 2 2 2 2 3 3 3 4 4 4 4 4 4 4 4 10 10 10 10 10 10 10 11 11 11 10 11 11 11 10 10 10 10 10 10 4 4 4 4 4 4 4
3 3 3 2 2 2 2 2 0 0 0 0 0 0 0 0 0 0 2 2 3 3 3 2 2 3 3 2 3 2 2 2 0 0 0 2 2 2 2 2 2 2 2 2 2 2 2 3 3 3 4 4 4 4 4 4 4 4 10 10 10 10 10 10 10 10 10 10 12 10 10 10 10 10 10 10 10 10 4 4 4 4 4 4 4
3 3 3 2 2 2 2 2 0 0 0 0 0 0 0 0 0 0 8 2 2 2 2 2 2 2 2 2 2 2 2 0 0 0 2 2 2 2 2 2 2 2 2 2 2 2 2 3 3 3 4 4 4 4 4 4 4 4 10 10 10 10 10 10 10 10 10 10 12 10 10 10 10 10 10 10 10 10 4 4 4 4 4 4 4
3 3 3 2 2 2 2 2 0 0 9 0 0 0 0 0 0 0 0 0 0 0 0 0 0 0 0 0 0 0 0 0 0 2 2 2 2 2 2 2 2 2 2 2 2 2 2 3 3 3 4 4 4 4 4 4 4 4 10 10 10 10 10 10 10 10 10 10 12 10 10 10 10 10 10 10 10 10 4 4 4 4 4 4 4
3 3 3 2 2 2 2 2 0 0 0 0 0 0 0 0 0 0 0 0 0 0 0 0 0 0 0 0 0 0 0 0 0 2 2 2 2 2 2 2 2 2 2 2 2 2 2 3 3 3 4 4 4 4 4 4 4 4 10 10 10 10 10 10 10 10 10 10 12 10 10 10 10 10 10 10 10 10 4 4 4 4 4 4 4
3 3 3 2 2 2 2 2 0 0 0 0 0 0 0 0 0 0 2 2 2 2 2 2 2 2 2 2 2 2 2 2 2 2 2 2 2 2 2 2 2 2 2 2 2 2 2 3 3 3 4 4 4 4 4 4 4 4 10 10 10 10 10 10 10 10 10 10 12 10 10 10 10 10 10 10 10 10 4 4 4 4 4 4 4
3 3 3 2 2 2 2 2 0 0 0 0 0 0 0 0 0 0 2 2 2 2 2 2 2 2 2 2 2 2 2 2 2 2 2 2 2 2 2 2 2 2 2 2 2 2 2 3 3 3 4 4 4 4 4 4 4 4 10 10 10 10 10 10 10 10 10 12 12 12 10 10 10 10 10 10 10 10 4 4 4 4 4 4 4
3 3 3 2 2 2 2 2 2 0 0 0 0 0 0 0 0 2 2 2 2 2 2 2 2 2 2 2 2 2 2 2 2 2 2 2 2 2 2 2 2 2 2 2 2 2 2 3 3 3 4 4 4 4 4 4 4 4 10 10 10 10 10 10 10 10 10 12 09 12 10 10 10 10 10 10 10 10 4 4 4 4 4 4 4
3 3 3 2 2 2 2 2 2 2 0 0 0 0 0 0 2 2 2 2 2 2 2 2 2 2 2 2 2 2 2 2 2 2 2 2 2 2 2 2 2 2 2 2 2 2 2 3 3 3 4 4 4 4 4 4 4 4 10 10 10 10 10 10 10 10 10 12 12 12 10 10 10 10 10 10 10 10 4 4 4 4 4 4 4
3 3 3 2 2 2 2 2 2 2 2 2 0 0 2 2 2 2 2 2 2 2 2 2 2 2 2 2 2 2 2 2 2 2 2 2 2 2 2 2 2 2 2 2 2 2 2 3 3 3 4 4 4 4 4 4 4 4 10 10 10 10 10 10 10 10 10 10 10 10 10 10 10 10 10 10 10 10 4 4 4 4 4 4 4
3 3 3 2 2 2 2 2 2 2 2 2 0 0 2 2 2 2 2 2 2 2 2 2 2 2 2 2 2 2 2 2 2 2 2 2 2 2 2 2 2 2 2 2 2 2 2 3 3 3 4 4 4 4 4 4 4 4 10 10 10 10 10 10 10 10 10 10 10 10 10 10 10 10 10 10 10 10 4 4 4 4 4 4 4
3 3 3 2 2 2 2 2 2 2 2 2 0 0 2 2 2 2 2 2 2 2 2 2 2 2 2 2 2 2 2 2 2 2 2 2 2 2 2 2 2 2 2 2 2 2 2 3 3 3 4 4 4 4 4 4 4 4 4 4 4 4 4 4 4 4 4 4 4 4 4 4 4 4 4 4 4 4 4 4 4 4 4 4 4
3 3 3 2 2 2 2 2 2 2 2 2 0 0 2 2 2 2 2 2 2 2 2 2 2 2 2 2 2 2 2 2 2 2 2 2 2 2 2 2 2 2 2 2 2 2 2 3 3 3 4 4 4 4 4 4 4 4 4 4 4 4 4 4 4 4 4 4 4 4 4 4 4 4 4 4 4 4 4 4 4 4 4 4 4
3 3 3 2 2 2 2 2 2 2 2 2 0 0 2 2 2 2 2 2 2 2 2 2 2 2 2 2 2 2 2 2 2 2 2 2 2 2 2 2 2 2 2 2 2 2 2 3 3 3 4 4 4 4 4 4 4 4 4 4 4 4 4 4 4 4 4 4 4 4 4 4 4 4 4 4 4 4 4 4 4 4 4 4 4
3 3 3 3 3 3 3 3 3 3 3 3 3 3 3 3 3 3 3 3 3 3 3 3 3 3 3 3 3 3 3 3 3 3 3 3 3 3 3 3 3 3 3 3 3 3 3 3 3 3 4 4 4 4 4 4 4 4 4 4 4 4 4 4 4 4 4 4 4 4 4 4 4 4 4 4 4 4 4 4 4 4 4 4 4
3 3 3 3 3 3 3 3 3 3 3 3 3 3 3 3 3 3 3 3 3 3 3 3 3 3 3 3 3 3 3 3 3 3 3 3 3 3 3 3 3 3 3 3 3 3 3 3 3 3 4 4 4 4 4 4 4 4 4 4 4 4 4 4 4 4 4 4 4 4 4 4 4 4 4 4 4 4 4 4 4 4 4 4 4
3 3 3 3 3 3 3 3 3 3 3 3 3 3 3 3 3 3 3 3 3 3 3 3 3 3 3 3 3 3 3 3 3 3 3 3 3 3 3 3 3 3 3 3 3 3 3 3 3 3 4 4 4 4 4 4 4 4 4 4 4 4 4 4 4 4 4 4 4 4 4 4 4 4 4 4 4 4 4 4 4 4 4 4 4
